0010000000000000
0010000000000000
0010011111111100
0010010000000100
0010010000000100
0011110011111100
0000000010000000
0000000010000000
0000000010000000